###########
#.#.#.#.#.#
##.#...#.##
#.#.....#.#
##.......##
#.........#
##...@...##
#.#.....#.#
##.#...#.##
#.#.#.#.#.#
###########