###########
#.........#
#.........#
#.........#
#.........#
#.........#
#....@....#
#.........#
#.........#
#.........#
###########