###########
#.........#
#.........#
#..#...#..#
#..#...#..#
#.........#
#....@....#
#.#.....#.#
#..#####..#
#.........#
###########